322222222222222222223
200000000000000000002
200000000000000000002
200000000000000030002
322222222222300020002
200000000000000030002
200000000000000000002
200030000000000000002
200020000322222222223
200030000111000000002
200000000000000000002
200000000000000030002
322222222222300020002
200000000000000030002
200000000000000000002
200030000000000000002
200020003222222222223
200030000000000000002
200000000000000000002
200000000000000000002
322222222222222222223
350
30
3
3