322223222333222322223
200002000232000200002
200003000020000300002
322300000000000003223
200000200000002000002
320000022000220000023
200000000202000000002
200020202000202020002
202200020000020002202
200000000111000000002
202200020000020002202
200020202000202020002
200000000202000000002
200020200202002020002
200200020000020002002
200000000323000000002
200020200000002020002
200200020020020002002
200000000232000000002
200000000232000000002
322222222333222222223
350
30
5
2